NO ./pics/test.xpm
SO ./pics/test.xpm
WE ./pics/test.xpm
EA ./pics/test.xpm
F 0,255,0
C 124,11,185
1111111111111111111111111
1000000000000000000000001
1000000000000000000000001
1000000000000000000000001
1000000000000000000000001
10000000000N0000000000001
1000000000000000000000001
1000000000000000000000001
1000000000000000000000001
1000000000000000000000001
1000000000000000000000001
1111111111111111111111111
